----- .---- .---- ----- ----- .---- .---- -----
----- .---- .---- ----- ----- .---- ----- .----
----- ----- .---- ----- ----- ----- ----- -----
----- .---- .---- ----- ----- ----- ----- -----
----- .---- ----- .---- .---- .---- .---- .----
----- .---- .---- ----- ----- ----- ----- -----
----- ----- .---- ----- ----- ----- ----- -----
----- .---- .---- ----- ----- ----- ----- -----
----- .---- .---- ----- ----- ----- ----- -----
----- .---- .---- ----- ----- .---- ----- .----
----- ----- .---- ----- ----- ----- ----- -----
----- .---- .---- ----- ----- ----- .---- -----
----- .---- .---- ----- .---- ----- ----- -----
----- ----- .---- ----- ----- ----- ----- -----
----- .---- .---- ----- ----- ----- ----- -----
----- .---- .---- ----- ----- ----- ----- -----
----- .---- .---- ----- ----- .---- ----- -----
----- ----- .---- ----- ----- ----- ----- -----
----- .---- .---- ----- ----- ----- .---- -----
----- .---- .---- ----- ----- ----- ----- .----
----- ----- .---- ----- ----- ----- ----- -----
----- .---- .---- ----- ----- ----- ----- -----
----- .---- ----- .---- .---- .---- .---- .----
----- .---- .---- ----- .---- ----- ----- -----
----- ----- .---- ----- ----- ----- ----- -----
----- .---- .---- ----- .---- ----- ----- -----
----- .---- .---- ----- ----- .---- .---- -----
----- ----- .---- ----- ----- ----- ----- -----
----- .---- .---- ----- ----- ----- ----- -----
----- .---- ----- .---- .---- .---- .---- .----
----- .---- .---- ----- ----- .---- .---- -----
----- ----- .---- ----- ----- ----- ----- -----
----- .---- .---- ----- ----- ----- ----- -----
----- .---- ----- .---- .---- .---- .---- .----
----- .---- .---- ----- ----- ----- ----- -----
----- ----- .---- ----- ----- ----- ----- -----
----- .---- .---- ----- ----- ----- .---- -----
----- .---- .---- ----- ----- ----- ----- .----
----- ----- .---- ----- ----- ----- ----- -----
----- .---- .---- ----- ----- ----- ----- -----
----- .---- .---- ----- ----- ----- ----- -----
----- .---- .---- ----- ----- .---- ----- .----
----- ----- .---- ----- ----- ----- ----- -----
----- .---- .---- ----- ----- ----- ----- -----
----- .---- ----- .---- .---- .---- .---- .----
----- .---- .---- ----- ----- ----- .---- .----
----- ----- .---- ----- ----- ----- ----- -----
----- .---- .---- ----- ----- ----- ----- -----
----- .---- ----- .---- .---- .---- .---- .----
----- .---- .---- ----- ----- .---- ----- -----
----- ----- .---- ----- ----- ----- ----- -----
----- .---- .---- ----- ----- ----- ----- -----
----- .---- .---- ----- ----- ----- ----- -----
----- .---- .---- ----- ----- .---- ----- -----
----- ----- .---- ----- ----- ----- ----- -----
----- .---- .---- ----- ----- ----- .---- -----
----- .---- .---- ----- ----- ----- ----- .----
----- ----- .---- ----- ----- ----- ----- -----
----- .---- .---- ----- .---- ----- ----- -----
----- .---- .---- ----- ----- .---- .---- -----
----- ----- .---- ----- ----- ----- ----- -----
----- .---- .---- ----- ----- ----- .---- -----
----- .---- .---- ----- ----- ----- ----- .----
----- ----- .---- ----- ----- ----- ----- -----
----- .---- .---- ----- .---- ----- ----- -----
----- .---- .---- ----- ----- .---- .---- .----
----- ----- .---- ----- ----- ----- ----- -----
----- .---- .---- ----- ----- ----- ----- -----
----- .---- ----- .---- .---- .---- .---- .----
----- .---- .---- ----- ----- .---- ----- -----
----- ----- .---- ----- ----- ----- ----- -----
----- .---- .---- ----- ----- ----- ----- -----
----- .---- .---- ----- ----- ----- ----- -----
----- .---- .---- ----- ----- .---- ----- .----
----- ----- .---- ----- ----- ----- ----- -----
----- .---- .---- ----- ----- ----- .---- -----
----- .---- .---- ----- ----- ----- ----- .----
----- ----- .---- ----- ----- ----- ----- -----
----- .---- .---- ----- ----- ----- ----- -----
----- .---- .---- ----- ----- ----- ----- -----
----- .---- .---- ----- ----- .---- ----- .----
----- ----- .---- ----- ----- ----- ----- -----
----- .---- .---- ----- ----- ----- ----- -----
----- .---- .---- ----- ----- ----- ----- -----
----- .---- .---- ----- ----- ----- .---- .----
----- ----- .---- ----- ----- ----- ----- -----
----- .---- .---- ----- ----- ----- ----- -----
----- .---- ----- .---- .---- .---- .---- .----
----- .---- .---- ----- ----- .---- ----- -----
----- ----- .---- ----- ----- ----- ----- -----
----- .---- .---- ----- .---- ----- ----- -----
----- .---- .---- ----- .---- ----- ----- -----
----- ----- .---- ----- ----- ----- ----- -----
----- .---- .---- ----- ----- ----- ----- -----
----- .---- ----- .---- .---- .---- .---- .----
----- .---- .---- ----- ----- .---- .---- -----
----- ----- .---- ----- ----- ----- ----- -----
----- .---- .---- ----- ----- ----- ----- -----
----- .---- ----- .---- .---- .---- .---- .----
----- .---- .---- ----- ----- .---- ----- -----
----- ----- .---- ----- ----- ----- ----- -----
----- .---- .---- ----- ----- ----- ----- -----
----- .---- ----- .---- .---- .---- .---- .----
----- .---- .---- ----- ----- ----- ----- -----
----- ----- .---- ----- ----- ----- ----- -----
----- .---- .---- ----- ----- ----- ----- -----
----- .---- .---- ----- ----- ----- ----- -----
----- .---- .---- ----- ----- ----- .---- .----
----- ----- .---- ----- ----- ----- ----- -----
----- .---- .---- ----- ----- ----- .---- .----
----- .---- .---- ----- ----- .---- ----- .----
----- ----- .---- ----- ----- ----- ----- -----
----- .---- .---- ----- ----- ----- .---- .----
----- .---- .---- ----- ----- .---- ----- .----
----- ----- .---- ----- ----- ----- ----- -----
----- .---- .---- ----- ----- ----- .---- .----
----- .---- .---- ----- ----- .---- ----- .----
